a	Эй.
b	Би.
c	Си.
d	Ди.
dash	Дефис.
dollar	Доллар.
dollar2	Долларов.
dollars	Доллары.
dot	Точка.
e	И.
equals	Равно.
euros	Евро.
exclamation-point	Восклицательный знак.
f	Эф.
g	Джи.
h	Эйч.
i	Ай.
j	Джэй.
k	Кэй.
l	Эл.
m	Эм.
n	Эн.
o	Оу.
p	Пи.
plus	Плюс.
q	Кью.
r	Ар.
s	Эс.
slash	Слэш.
space	Пробел.
t	Ти.
u	Ю.
v	Ви.
w	Дабл Ю.
x	Экс.
y	Уай.
z	Зэт.
zed	ЗэД.
