9_p	Девятый. 
a_p	Альфа.
b_p	Браво.
c_p	Чарли.
d_p	Дэльта.
e_p	Эхо.
f_p	Фокстрот.
g_p	Гольф.
h_p	Отель.
i_p	Индия.
j_p	Джульетта.
k_P	Кило.
l_p	Лима.
m_p	Майк.
n_p	Ноябрь.
o_p	Оскар.
p_p	Папа.
q_p	Квебек.
r_p	Ромео.
s_p	Съерра.
t_p	Танго.
u_p	Униформа.
v_p	Виктор.
w_p	Виски.
x_p	Рентген.
y_p	Янки.
z_p	Зулу.
